{
    "groundTextureUrl": "./textures/ground.jpg",
    "wallTextureUrl": "./textures/wall.jpg",
    "size": { "width": 15, "height": 8 },
    "map": [
        [3, 2, 2, 2, 3, 2, 3, 2, 2, 3, 2, 2, 3, 2, 2, 1],
        [1, 0, 0, 1, 1, 0, 1, 0, 0, 1, 0, 0, 1, 0, 0, 1],
        [1, 0, 0, 1, 1, 0, 0, 0, 0, 0, 0, 0, 1, 0, 0, 1],
        [1, 0, 0, 0, 2, 2, 2, 2, 2, 2, 0, 0, 2, 4, 2, 1],
        [1, 0, 0, 0, 0, 0, 0, 0, 0, 0, 0, 0, 0, 0, 0, 1],
        [1, 0, 0, 3, 4, 2, 3, 4, 2, 3, 4, 2, 3, 4, 2, 1],
        [1, 0, 0, 1, 0, 0, 1, 0, 0, 1, 0, 0, 1, 0, 0, 1],
        [1, 0, 0, 1, 0, 0, 1, 0, 0, 1, 0, 0, 1, 0, 0, 1],
        [2, 2, 2, 2, 2, 2, 2, 2, 2, 2, 2, 2, 2, 2, 2, 0]
    ],
    "initialPosition": [1, 1],
    "initialDirection": 0.0,
    "exitLocation": [-0.5, 6]
}